0 0 0 0 0 0 0 0 0 0 0 0 0 0 0 0 0 0 0 0 0 0 0 0 0 0 0 0 0 0 0 0 0 0 0 0 0 0 0 0 0 0 0 0 0 0 0 0 0 0 
0 36 28 28 28 28 28 28 28 28 28 28 32 0 0 0 0 0 0 0 0 0 0 0 0 0 0 0 0 0 0 0 0 0 0 0 0 0 0 0 0 0 0 0 0 0 0 0 0 0 
0 38 27 27 39 27 13 14 27 39 27 27 33 0 0 0 0 0 0 0 0 0 0 0 0 0 0 0 0 0 0 0 0 0 0 0 0 0 0 0 0 0 0 0 0 0 0 0 0 0 
0 38 31 31 31 30 15 16 29 31 31 31 33 0 0 0 0 0 0 0 0 0 0 0 0 0 0 0 0 0 0 0 0 0 0 0 0 0 0 0 0 0 0 0 0 0 0 0 0 0 
0 38 9 9 9 9 9 9 9 9 9 9 33 0 0 0 0 0 0 0 0 0 0 0 0 0 0 0 0 0 0 0 0 0 0 0 0 0 0 0 0 0 0 0 0 0 0 0 0 0 
0 38 9 9 9 1 9 9 2 9 1 9 33 0 0 0 0 0 0 0 0 0 0 0 0 0 0 0 0 0 0 0 0 0 0 0 0 0 0 0 0 0 0 0 0 0 0 0 0 0 
0 38 9 2 9 9 9 9 9 9 9 9 33 0 0 0 0 0 0 0 0 0 0 0 0 0 0 0 0 0 0 0 0 0 0 0 0 0 0 0 0 0 0 0 0 0 0 0 0 0 
0 38 9 9 9 9 9 9 9 9 2 9 33 0 0 0 0 0 0 0 0 0 0 0 0 0 0 0 0 0 0 0 0 0 0 0 0 0 0 0 0 0 0 0 0 0 0 0 0 0 
0 38 9 9 9 9 5 6 9 9 9 9 33 0 0 0 0 0 0 0 0 0 0 0 0 0 0 0 0 0 0 0 0 0 0 0 0 0 0 0 0 0 0 0 0 0 0 0 0 0 
0 38 9 4 9 9 7 8 9 9 9 1 33 0 0 0 0 0 0 0 0 0 0 36 28 28 28 28 28 28 28 28 28 28 28 28 28 28 28 28 28 28 28 28 32 0 0 0 0 0 
0 38 9 9 2 9 9 9 9 9 9 9 33 0 0 0 0 0 0 0 0 0 0 38 27 27 39 27 27 39 27 27 39 27 27 39 27 27 39 27 27 39 27 27 33 0 0 0 0 0 
0 38 1 9 9 9 2 9 9 9 9 9 33 0 0 0 0 0 0 0 0 0 0 38 31 31 31 31 31 31 31 31 31 31 31 31 31 31 31 31 31 31 31 31 33 0 0 0 0 0 
0 38 9 9 9 9 9 9 9 9 9 9 33 0 0 0 0 0 0 0 0 0 0 38 9 9 9 9 9 9 9 9 9 9 9 9 9 9 9 9 9 9 9 9 33 0 0 0 0 0 
0 38 9 9 9 9 9 9 9 9 9 9 33 0 0 0 0 0 0 0 0 0 0 38 9 2 9 3 9 3 9 9 9 9 9 9 9 2 9 3 1 9 2 9 33 0 0 0 0 0 
0 35 37 37 37 42 9 9 43 37 37 37 34 0 0 0 0 0 0 0 0 0 0 38 9 9 9 9 9 9 9 9 9 9 9 9 9 9 9 9 9 9 9 9 33 0 0 0 0 0 
0 36 28 28 28 40 9 9 41 28 28 28 28 28 28 28 28 32 0 0 0 0 0 38 9 9 4 9 9 2 9 9 9 9 3 9 9 9 9 9 9 9 9 9 33 0 0 0 0 0 
0 38 27 27 39 27 13 14 27 27 27 39 27 27 39 27 27 33 0 0 0 0 0 38 9 9 9 9 9 9 9 9 9 9 9 9 3 9 3 9 9 9 9 3 33 0 0 0 0 0 
0 38 31 31 31 29 15 16 31 31 31 31 31 29 31 31 31 33 0 0 0 0 0 38 9 9 9 1 9 9 9 9 9 9 2 9 9 9 9 9 9 9 9 9 33 0 0 0 0 0 
0 38 9 1 9 9 9 9 3 9 9 4 2 9 9 9 3 33 0 0 0 0 0 38 9 9 9 9 9 9 9 9 9 9 9 9 9 9 9 9 2 9 9 9 33 0 0 0 0 0 
0 38 9 9 10 10 10 10 9 9 9 9 2 9 9 9 1 33 0 0 0 0 0 38 2 9 3 9 9 9 9 9 3 9 9 9 9 9 9 9 9 9 2 9 33 0 0 0 0 0 
0 38 9 9 11 11 11 11 9 9 9 9 9 9 9 9 9 33 0 0 0 0 0 38 9 9 9 9 9 9 1 9 9 9 9 9 9 9 1 9 9 9 9 9 33 0 0 0 0 0 
0 38 9 9 12 12 12 12 9 9 9 9 9 9 9 9 9 33 0 0 0 0 0 38 9 9 9 9 9 9 9 9 9 9 9 9 9 9 9 9 3 9 9 9 33 0 0 0 0 0 
0 38 4 3 9 2 9 9 9 9 4 9 9 3 9 1 9 33 0 0 0 0 0 38 9 9 9 9 9 9 9 9 9 9 9 9 9 9 9 9 9 9 9 9 33 0 0 0 0 0 
0 35 37 37 37 37 37 37 37 42 9 9 43 37 37 37 37 34 0 0 0 0 0 38 9 9 2 9 9 3 9 9 9 9 9 9 9 9 9 9 9 9 9 1 33 0 0 0 0 0 
0 0 0 0 36 28 28 28 28 40 9 9 41 28 28 28 28 32 0 0 0 0 0 38 10 10 10 10 10 10 10 10 10 10 10 10 10 10 10 10 10 10 10 10 33 0 0 0 0 0 
0 0 0 0 38 27 39 27 39 27 13 14 27 39 27 39 27 33 0 0 0 0 0 38 11 11 11 11 11 11 11 11 11 11 11 11 11 11 11 11 11 11 11 11 33 0 0 0 0 0 
0 0 0 0 38 31 31 29 31 31 15 16 31 31 31 31 31 33 0 0 0 0 0 38 12 12 12 12 12 12 12 12 12 12 12 12 12 12 12 12 12 12 12 12 33 0 0 0 0 0 
0 0 0 0 38 9 9 9 9 9 9 9 3 9 9 9 9 33 0 0 0 0 0 38 9 3 9 9 9 9 9 9 9 9 9 2 9 9 9 9 9 9 3 9 33 0 0 0 0 0 
0 0 0 0 38 9 1 10 10 10 10 10 10 10 10 9 3 33 0 0 0 0 0 38 9 9 9 9 9 9 9 9 9 9 9 9 9 9 9 4 1 9 9 3 33 0 0 0 0 0 
0 0 0 0 38 9 9 11 11 11 11 11 11 11 11 2 9 33 0 36 28 28 32 38 9 1 9 9 9 9 9 9 9 3 9 9 9 1 9 9 9 9 2 9 33 0 0 0 0 0 
0 0 0 0 38 9 9 11 11 11 11 11 11 11 11 9 9 33 0 38 9 9 33 38 9 9 9 9 9 9 9 9 9 9 9 9 9 9 9 9 9 9 9 9 33 0 0 0 0 0 
0 0 0 0 38 9 9 11 11 11 11 11 11 11 11 9 9 33 0 38 9 9 33 38 9 9 9 9 2 1 9 9 9 9 9 9 9 9 9 3 9 9 9 9 33 0 0 0 0 0 
0 0 0 0 38 3 9 11 11 11 5 6 11 11 11 9 9 33 0 21 22 22 23 35 37 37 37 37 37 37 37 37 37 37 42 9 9 43 37 37 37 37 37 37 34 0 0 0 0 0 
0 0 0 0 38 9 2 11 11 11 7 8 11 11 11 9 9 33 0 38 24 24 33 36 28 28 28 28 28 28 28 28 28 28 40 9 9 41 28 32 0 0 0 0 0 0 0 0 0 0 
0 0 0 0 38 9 9 11 11 11 11 11 11 11 11 2 9 33 0 38 25 25 33 38 27 27 13 14 27 39 27 27 27 27 39 13 14 27 27 33 0 0 0 0 0 0 0 0 0 0 
0 0 0 0 38 9 9 11 11 11 11 11 11 11 11 9 9 33 36 40 26 26 41 40 31 31 15 16 31 31 31 31 31 31 31 15 16 31 31 33 0 0 0 0 0 0 0 0 0 0 
0 0 0 0 38 9 4 11 11 11 11 11 11 11 11 4 9 33 38 9 9 9 9 9 9 9 9 9 9 9 9 9 9 9 9 9 9 9 9 33 0 0 0 0 0 0 0 0 0 0 
0 0 0 0 38 1 9 12 12 12 12 12 12 12 12 9 1 33 38 9 9 9 9 9 9 10 10 10 10 10 9 3 9 10 10 10 10 10 9 33 0 0 0 0 0 0 0 0 0 0 
0 0 0 0 38 2 3 2 3 2 3 2 3 2 3 2 3 33 38 9 9 43 37 42 1 11 11 11 11 11 1 3 1 11 11 11 11 11 2 33 0 0 0 0 0 0 0 0 0 0 
0 0 0 0 35 37 37 37 37 37 42 9 9 43 37 37 37 34 38 9 9 33 0 38 1 11 11 11 11 11 2 3 1 11 11 11 11 11 2 33 0 0 0 0 0 0 0 0 0 0 
0 36 28 28 28 28 28 28 28 28 40 9 9 41 28 28 28 28 40 9 9 41 32 38 1 11 11 11 11 11 1 3 2 11 11 11 11 11 2 33 0 0 0 0 0 0 0 0 0 0 
0 38 27 13 14 27 27 27 27 39 27 13 14 27 27 27 27 39 27 13 14 27 33 38 1 11 11 11 11 11 2 3 1 11 11 11 11 11 2 33 0 0 0 0 0 0 0 0 0 0 
0 38 31 15 16 31 31 31 31 31 31 15 16 31 31 31 31 31 31 15 16 31 33 38 1 11 11 11 11 11 1 3 2 11 11 11 11 11 2 33 0 0 0 0 0 0 0 0 0 0 
0 38 9 9 9 9 9 9 9 9 9 9 9 9 9 9 9 9 9 9 9 9 33 38 1 11 11 11 11 11 2 3 1 11 11 11 11 11 2 33 0 0 0 0 0 0 0 0 0 0 
0 38 9 10 10 9 9 9 9 9 9 5 6 9 9 9 9 9 9 10 10 9 33 38 1 11 11 11 11 11 1 3 2 11 11 11 11 11 2 33 0 0 0 0 0 0 0 0 0 0 
0 38 9 11 11 9 9 9 9 9 9 7 8 9 9 9 9 9 9 11 11 9 33 38 1 12 12 12 12 12 2 3 1 12 12 12 12 12 2 33 0 0 0 0 0 0 0 0 0 0 
0 38 9 12 12 9 9 9 9 9 9 9 9 9 9 9 9 9 9 12 12 9 33 35 37 37 37 37 37 37 37 37 37 37 37 37 37 37 37 34 0 0 0 0 0 0 0 0 0 0 
0 38 9 9 9 9 9 9 9 9 9 9 9 9 9 9 9 9 9 9 9 9 33 0 0 0 0 0 0 0 0 0 0 0 0 0 0 0 0 0 0 0 0 0 0 0 0 0 0 0 
0 35 37 37 37 37 37 37 37 37 37 37 37 37 37 37 37 37 37 37 37 37 34 0 0 0 0 0 0 0 0 0 0 0 0 0 0 0 0 0 0 0 0 0 0 0 0 0 0 0 
0 0 0 0 0 0 0 0 0 0 0 0 0 0 0 0 0 0 0 0 0 0 0 0 0 0 0 0 0 0 0 0 0 0 0 0 0 0 0 0 0 0 0 0 0 0 0 0 0 0